{
	"backgroundImage": "images\/level.png",
	"rows": [
		"1110000000000000000000",
		"1000000000001000011000",
		"1000111100001100000000",
		"1000000000011110000011",
		"1100000000111000000001",
		"1110001111110000000001",
		"1000000000000011110001",
		"1000000000000000000011",
		"1110011100000000000111",
		"1000000000003100000001",
		"1000000000031110000001",
		"1011110000311111111001",
		"1000000000000000000001",
		"1100000000000000000011",
		"2222222214000001333111",
		"2222222211111111111111"
	]
}